######################################################################
# ##############             #   #                                   #
#                ############# # ############# ##################### #
# ################             # #           # #########             #
#                  ############# #############       ### ########### #
####################             #             ##### ###           # #
#                    ############# ################# ############### #
# ####################             #                                 #
#                      ###############################################
# ######################                                             #
#                        ####### ################################### #
# ##########################   # #                                   #
# #   #                      # # # ################### # ########### #
# # # ######################## # #                   # # ########### #
# # # #                        # ################### # #           # #
# # # # ######################## #                   # ########### # #
#   # #                          # ###################             # #
##### ########################## # #################################k#
#                                #                                   2
######################################################################